#Iberia
CNR = "countries/Canaries.txt"
TAO = "countries/Taoro.txt"
GLD = "countries/Galdar.txt"
BNR = "countries/Benahoare.txt"
SEV = "countries/Sevilla.txt"
CRD = "countries/Cordoba.txt"
VZC = "countries/Vizcaya.txt"
EXT = "countries/Extremadura.txt"
#ATS = "countries/Asturias.txt" #PRETTY SURE VANILLA HAS THIS.
CIM = "countries/Coimbra.txt"
VSU = "countries/Viseu.txt"
BGC = "countries/Braganca.txt"
BJ1 = "countries/BejaPor.txt"
LLI = "countries/Lleida.txt"
A7D = "countries/Andorra.txt"
LSA = "countries/Lusitania.txt"
SN7 = "countries/SanSebastian.txt"
GR4 = "countries/ChristianGranada.txt"

#France
ABT = "countries/Albret.txt"
PRI = "countries/Perigord.txt"
LIM = "countries/Limoges.txt"
LMA = "countries/LaMarche.txt"
AGU = "countries/Angoumois.txt"
BCN = "countries/Besancon.txt"
POI = "countries/Poitou.txt"
ORA = "countries/Orange.txt"
REI = "countries/Reims.txt"
MZ1 = "countries/MetzCity.txt"
DUN = "countries/Dunois.txt"
CMG = "countries/Commingues.txt"
VDM = "countries/Vendome.txt"
OCC = "countries/Occitania.txt"
VUS = "countries/Vertus.txt"
SAC = "countries/Sancerre.txt"
NMO = "countries/Nemours.txt"
ANO = "countries/Anjou.txt"
T0N = "countries/Tonnerre.txt"
CL3 = "countries/Clermont.txt"
AU4 = "countries/Auxerrois.txt"

#Franco-Brittania
AGV = "countries/Angevinia.txt"

#Ireland
AN4 = "countries/Annaly.txt"
RSC = "countries/Roscommon.txt"
IVG = "countries/Iveagh.txt"
M0G = "countries/Monaghan.txt"
FRG = "countries/Fermanagh.txt"
BRF = "countries/Breifne.txt"
L1T = "countries/Leitrim.txt"
UML = "countries/Umaill.txt"
TLS = "countries/Tulsk.txt"
I4R = "countries/IarConnact.txt"
WFD = "countries/Waterford.txt"
CRK = "countries/Cork.txt"
OCN = "countries/Colerain.txt"
FTZ = "countries/Kerry.txt"
KEN = "countries/Nenagh.txt"
OSV = "countries/Beare.txt"
LAO = "countries/Laois.txt"

#Britain and Wales
BRC = "countries/Brecon.txt"
CSR = "countries/Cheshire.txt"
DBG = "countries/Denbigh.txt"
GLM = "countries/Glamorgan.txt"
GWR = "countries/Gower.txt"
PMB = "countries/Pembroke.txt"
PWY = "countries/Powys.txt"
YRK = "countries/York.txt"

#Scotland
ANG = "countries/Angus.txt"
AOL = "countries/Atholl.txt"
CAI = "countries/Caithness.txt"
CCK = "countries/Carrick.txt"
C3N = "countries/Cameron.txt"
CPB = "countries/Campbell.txt"
CRW = "countries/Crawford.txt"
DNB = "countries/Dunbar.txt"
DOU = "countries/Douglas.txt"
FIF = "countries/Fife.txt"
GLY = "countries/Galloway.txt"
GRD = "countries/Gordon.txt"
LNN = "countries/Lennox.txt"
MCL = "countries/Macleod.txt"
MCN = "countries/Maclean.txt"
MKN = "countries/Chattan.txt"
MKY = "countries/Mackay.txt"
MKZ = "countries/Mackenzie.txt"
MRY = "countries/Moray.txt"
MTE = "countries/Menteith.txt"
RSS = "countries/Ross.txt"
SUT = "countries/Sutherland.txt"

#Switzerland
BRN = "countries/Bern.txt"
#GNV = "countries/Geneva.txt"
ZCH = "countries/Zurich.txt"
APZ = "countries/Appenzell.txt"
SWZ = "countries/Schwyz.txt"
FRB = "countries/Freibourg.txt"
THG = "countries/Thurgau.txt"
URI = "countries/Uri.txt"
UTW = "countries/Unterwalden.txt"
LUZ = "countries/Lucerne.txt"
SCH = "countries/Schaffhausen.txt"
NEU = "countries/Neuchatel.txt"
STH = "countries/Solothurn.txt"
VAD = "countries/Vaud.txt"

#Yugoslavia
DSS = "countries/SaintSava.txt"

###HRE
#SleswigHolstein
#SLW = "countries/Schleswig.txt"
PIN = "countries/Pinneberg.txt"
DHL = "countries/DucalHolstein.txt"
SBG = "countries/Sonderburg.txt"
NFL = "countries/Nordfriesland.txt"
#N-Germany
BNT = "countries/Bentheim.txt"
CTT = "countries/Cottbus.txt"
FSK = "countries/Freikoln.txt"
HLD = "countries/Hildesheim.txt"
RVB = "countries/Ravensberg.txt"
HDL = "countries/Hadeln.txt"
TEC = "countries/Tecklenburg.txt"
LUK = "countries/Lubeck.txt"
WLD = "countries/Waldeck.txt"
SAY = "countries/Sayn.txt"
HLB = "countries/Halberstadt.txt"
#GOS = "countries/Goslar.txt"
RTZ = "countries/Ratzeburg.txt"
SW8 = "countries/Schwarzburg.txt"
ZGH = "countries/Ziegenhain.txt"
BR1 = "countries/BremenBishop.txt"
SCM = "countries/Schaumburg.txt"
#CBG = "countries/Calenberg.txt" #CONVERT TO VANILLA
GTN = "countries/Gottingen.txt"
WLF = "countries/Wolfenbuttel.txt"
HNU = "countries/Hanau.txt"
SPH = "countries/Sponheim.txt"
WEI = "countries/Weimar.txt"
REU = "countries/Reuss.txt"
MUH = "countries/Muhlhausen.txt"
TOG = "countries/Torgau.txt"
ERF = "countries/Erfurt.txt"
#S-Germany
KTZ = "countries/Katzenelnbogen.txt"
CNT = "countries/Carinthia.txt"
FUB = "countries/Furstenberg.txt"
WOM = "countries/Worms.txt"
ZWB = "countries/Zweibrucken.txt"
EIC = "countries/Eichstadt.txt"
SCW = "countries/Schweinfurt.txt"
H4L = "countries/SwabischHall.txt"
NDL = "countries/Nordlingen.txt"
BCH = "countries/Biberach.txt"
RTW = "countries/Rottweil.txt"
OFF = "countries/Offenburg.txt"
KMP = "countries/Kempten.txt"
SPY = "countries/Speyer.txt"
SCB = "countries/Schaunberg.txt"
HNB = "countries/Henneberg.txt"
FEI = "countries/Freising.txt"
EGE = "countries/Eger.txt"
OFK = "countries/Ostfranken.txt"
HNS = "countries/HesseNassau.txt"
WU1 = "countries/Stuttgart.txt"
WU2 = "countries/Urach.txt"
M3R = "countries/Merseburg.txt"
OET = "countries/Oettingen.txt"
GAU = "countries/Breisgau.txt"
#RTH = "countries/Rothenburg.txt" #CONVERT TO VANILLA
#PAU = "countries/Passau.txt" #CONVERT TO VANILLA
#BV1 = "countries/BavariaMunchen.txt" #CONVERT TO VANILLA
#BV2 = "countries/BavariaLandshut.txt" #CONVERT TO VANILLA
#BV3 = "countries/BavariaIngolstadt.txt" #CONVERT TO VANILLA

#Pomerania-Prussia
BUT = "countries/Butow.txt"
PM0 = "countries/Stralsund.txt"
#WRM = "countries/Warmia.txt"
#WLG = "countries/Wolgast.txt"
#STT = "countries/Stettin.txt"
#PM1 = "countries/Stolp.txt" #NEEDS REMOVAL
LNB = "countries/Lauenburg.txt"
KBG = "countries/Konigsberg.txt"
KCW = "countries/Kociewie.txt"
ELB = "countries/Elbing.txt"
PTZ = "countries/Putzig.txt"
MML = "countries/Memel.txt"
RVL = "countries/Reval.txt"
VEP = "countries/Vepsia.txt"
VRO = "countries/Voro.txt"
YOT = "countries/Yotvingia.txt"
PTH = "countries/Pruthenia.txt"
KAB = "countries/Kashubia.txt"
IGR = "countries/Ingria.txt"
LTV = "countries/Latvia.txt"
LTG = "countries/Latgallia.txt"
SGL = "countries/Semigalia.txt"
SEL = "countries/Selonia.txt"
CUR = "countries/Curonia.txt"
TCH = "countries/Tuchel.txt"
SCL = "countries/Schlochau.txt"
SGD = "countries/StarogardGdanski.txt"
RPU = "countries/RoyalPrussia.txt"

#Silesia
LGN = "countries/Legnica.txt"
BZG = "countries/Brzeg.txt"
#OPO = "countries/Opole.txt" #CONVERT TO VANILLA
OPV = "countries/Opava.txt"
#GLG = "countries/Glogow.txt" #REPLACED IN VANILLA
TCN = "countries/Teschen.txt"
WRC = "countries/Wroclaw.txt"
SV1 = "countries/Svidnica.txt"
OSW = "countries/Oswiecim.txt"
OLS = "countries/Olesnica.txt"
NYS = "countries/Nysa.txt"
ZAG = "countries/Zagan.txt"
#Other
#CLJ = "countries/Celje.txt" #CONVERT TO VANILLA
#RIJ = "countries/Rijeka.txt"

#Elsass-Lorraine
HAG = "countries/Haguenau.txt"
STS = "countries/Strassburg.txt"
SUD = "countries/Sundgau.txt"
TUL = "countries/Toul.txt"
C0L = "countries/Colmar.txt"
SLM = "countries/Salm.txt"
L1C = "countries/Lichtenberg.txt"
D3C = "countries/Decapole.txt"
SW4 = "countries/SwabianLeague.txt"
MRB = "countries/Murbach.txt"
VAU = "countries/Vaudemont.txt"

#Lowlands
ARS = "countries/Artois.txt"
BNL = "countries/BurgundianNetherlands.txt" #PENDING REMOVAL
BOI = "countries/Bouillon.txt"
BTV = "countries/Batavia.txt" #PENDING REMOVAL
DOO = "countries/Doornik.txt"
LBG = "countries/Limburg.txt"
NAM = "countries/Namur.txt"
WLL = "countries/Wallonie.txt"
ZEE = "countries/Zeeland.txt"
ZUT = "countries/Zutphen.txt"
BR3 = "countries/Breda.txt"
MEC = "countries/Mechelen.txt"
CIJ = "countries/Cuijk.txt"
FR1 = "countries/Westergo.txt"
FR2 = "countries/Oostergo.txt"
FR3 = "countries/Zevenwouden.txt"
FR4 = "countries/Hunsingo.txt"
FR5 = "countries/Oldambt.txt"
FR6 = "countries/Jever.txt"
FR7 = "countries/Westfriesland.txt"
IJS = "countries/Overijssel.txt"
DRE = "countries/Drenthe.txt"
#OMM = "countries/Ommelanden.txt"
#STV = "countries/Stavelot.txt"

#HRE formables
NGC = "countries/NorthGermanConfederation.txt"
SGC = "countries/SouthGermanConfederation.txt"
DNC = "countries/DanubeConfederacy.txt"
RHN = "countries/Rheinland.txt"
DPU = "countries/DuchyPrussia.txt"

#Scandinavia
ORK = "countries/Orkney.txt"
FRO = "countries/Faroe.txt"
VYB = "countries/Vyborg.txt"
SKN = "countries/Skania.txt"
JTL = "countries/Jutland.txt"
BHM = "countries/Bornholm.txt"
HLS = "countries/Helsingia.txt"
DLN = "countries/Dalarna.txt"
JMT = "countries/Jemtland.txt"
LDE = "countries/Lade.txt"
HLL = "countries/Halland.txt"
ALD = "countries/Aland.txt"
ALV = "countries/Alvsborg.txt"
ASL = "countries/Asele.txt"
BKG = "countries/Blekinge.txt"
CPN = "countries/Copenhagen.txt"
FNN = "countries/Funen.txt"
GRP = "countries/Gripsholm.txt"
HLG = "countries/Helsingborg.txt"
JAA = "countries/Jaameren.txt"
KLA = "countries/Kolan.txt"
KMM = "countries/Kemin.txt"
KMR = "countries/Kalmar.txt"
KRH = "countries/Korsholm.txt"
KTN = "countries/Koltan.txt"
KUU = "countries/Kuusamo.txt"
KVE = "countries/Kvens.txt"
LLJ = "countries/Luulajin.txt"
MLM = "countries/Malmo.txt"
NRK = "countries/Orebro.txt"
NYK = "countries/Nykoping.txt"
OLN = "countries/Oland.txt"
OSB = "countries/Ostrobothnia.txt"
PII = "countries/Piitimen.txt"
PRV = "countries/Porvoo.txt"
RGH = "countries/Ringstaholm.txt"
RSB = "countries/Raseborg.txt"
SKT = "countries/Satakunta.txt"
STG = "countries/Stegeborg.txt"
SVA = "countries/Savonia.txt"
TNO = "countries/Tornion.txt"
TRK = "countries/Turku.txt"
TVS = "countries/Tavastia.txt"
UUM = "countries/Uumajam.txt"
VST = "countries/Vasteras.txt"
ZLN = "countries/DanishZealand.txt"

#Italy
#ALA = "countries/Alatri.txt" #Already present in btp_countries
SNS = "countries/Serenissima.txt"
LMB = "countries/Lombardy.txt"
LGA = "countries/Liguria.txt"
CAA = "countries/Calabria.txt"			#Regional cores for shattering. Dub change from CLB to CBR in 1.30 due to tag conflict.
F8M = "countries/Fermo.txt"
S0R = "countries/Sora.txt" #Dub changed from SOR to SRA in 1.30 due to tag conflict.
#TSI = "countries/TwoSicilies.txt" #CONVERT TO VANILLA
#TTN = "countries/Tortona.txt"
BGO = "countries/Bergamo.txt"

#Ruthenia
PDL = "countries/Podolia.txt"
DYK = "countries/Dykra.txt" #Lithuania Wild Lands

#North America
A4B = "countries/Alabama.txt"
A4C = "countries/Alabama-Coushatta.txt"
A4K = "countries/Akokisa.txt"
A4L = "countries/Apalachee.txt"
A4T = "countries/Atakapa.txt"
C4B = "countries/Cusabo.txt"
C4F = "countries/Cofitachequi.txt"
C4I = "countries/Cibola.txt"
C4R = "countries/Comecrudo.txt"
C4T = "countries/Chitimacha.txt"
C4U = "countries/Calusa.txt"
C4W = "countries/Catawba.txt"
G4L = "countries/Guale.txt"
H4I = "countries/Hitchiti.txt"
H4N = "countries/Hasinai.txt"
J4M = "countries/Jumano.txt"
K4H = "countries/Kadohadacho.txt"
K4K = "countries/Karankawa.txt"
#K4W = "countries/Kituhwa.txt" - removed
K4R = "countries/Koroa.txt"
K4S = "countries/Koasati.txt"
K4T = "countries/Kichai.txt"
L4C = "countries/LowerCreeks.txt"
L4Y = "countries/Lipiyane.txt"
M4C = "countries/Mocama.txt"
M4E = "countries/Mayeye.txt"
M4Y = "countries/Mayaca.txt"
N4C = "countries/Natchez.txt"
N4G = "countries/Natage.txt"
N4H = "countries/Natchitoches.txt"
P4C = "countries/Pensacola.txt"
P4L = "countries/Pelone.txt"
P4W = "countries/Pakawa.txt"
P4T = "countries/Potano.txt"
Q4W = "countries/Quapaw.txt"
S4M = "countries/Seminole.txt"
T4B = "countries/Tocobaga.txt"
T4K = "countries/Tonkawa.txt"
T4M = "countries/Timucua.txt"
T4N = "countries/Tunica.txt"
T4S = "countries/Taensa.txt"
T4V = "countries/Taovaya.txt"
T4W = "countries/Tawakoni.txt"
U4C = "countries/UpperCreeks.txt"
U5N = "countries/Unami.txt"
U5L = "countries/Unalachtigo.txt"
W4C = "countries/Western Cherokee.txt"
W4M = "countries/Waccamaw.txt"
Y4D = "countries/Ypande.txt"
Y4J = "countries/Yojuane.txt"
Y4M = "countries/Yamassee.txt"
Y4U = "countries/Yuchi.txt"
Y4Z = "countries/Yazoo.txt"
W3F = "countries/WestFlorida.txt"
S3M = "countries/StateMuskogee.txt"
E5I = "countries/Erie.txt"
S5C = "countries/Secotan.txt"
T5R = "countries/Tuscarora.txt"
M5A = "countries/Manahoac.txt"
M5C = "countries/Monacan.txt"
O5C = "countries/Occaneechi.txt"
T5U = "countries/Tutelo.txt"
P5C = "countries/Piscataway.txt"
N5T = "countries/Nanticoke.txt"
K5T = "countries/Kentaientonga.txt"
A5G = "countries/Arrigahaga.txt"
H5O = "countries/Honniasont.txt"
M5W = "countries/Massawomeck.txt"
S5E = "countries/Seneca.txt"
O5N = "countries/Oneida.txt"
O5D = "countries/Onondaga.txt"
C5Y = "countries/Cayuga.txt"
M5K = "countries/Mohawk.txt"
M5U = "countries/Munsee.txt"
J5U = "countries/Juniata.txt"
S5H = "countries/Scahentoahronon.txt"
P5Q = "countries/Piqua.txt"
H5W = "countries/Hathawekela.txt"
M5G = "countries/Mohegan.txt"
N5P = "countries/Nipmuc.txt"
N5G = "countries/Narragansett.txt"
W5M = "countries/Wampanoag.txt"
W5P = "countries/Wappinger.txt"
E5S = "countries/Esopus.txt"
W5N = "countries/Wenro.txt"
P5N = "countries/Pennacook.txt"
P5B = "countries/Penobscot.txt"
P5S = "countries/Passamaquoddy.txt"
S5K = "countries/Sokoki.txt"

#COLONIAL AMERICA
#V3T = "countries/Vermont.txt"

#CRUSADER STATES
MLL = "countries/CrusaderMelilla.txt" 
TGR = "countries/CrusaderTangiers.txt" 
CTA = "countries/CrusaderCeuta.txt" 
CSB = "countries/Casablanca.txt" 
ZIZ = "countries/Ziz.txt" 
CDI = "countries/Chaldia.txt"
LHS = "countries/CrusaderLahsa.txt"
SHI = "countries/ShinarCrusader.txt"
ASR = "countries/AsshurCrusader.txt" 
ELA = "countries/ElamCrusader.txt" 
BSS = "countries/BassorahCrusader.txt" 
GMB = "countries/Gombraun.txt"
HIP = "countries/Hippo.txt" 
CPS = "countries/Capsa.txt" 
CNS = "countries/CrusaderConstantine.txt" 
MZA = "countries/Mozab.txt" 
AGR = "countries/CrusaderAlgiers.txt" 
ORN = "countries/Oran.txt" 
LHU = "countries/Laghuatensis.txt" 
FAZ = "countries/Faz.txt" 
DRA = "countries/Draa.txt" 
JRB = "countries/Jerba.txt" 
AFR = "countries/KingdomofAfrica.txt" 
PHZ = "countries/Phazania.txt" 
TPT = "countries/Tripolitania.txt" 
PPL = "countries/PentapolisCyrene.txt" 
CSW = "countries/CrusaderSiwa.txt" 
TBS = "countries/CrusaderThebes.txt" 
DMT = "countries/Damietta.txt" 
GSN = "countries/Goshen.txt" 
MRR = "countries/MareRubrum.txt" 
C4O = "countries/Cairo.txt" 
ALX = "countries/Alexandria.txt" 
TYB = "countries/Taybah.txt" 
TAL = "countries/Tualias.txt" 
SNI = "countries/Sinai.txt" 
PLM = "countries/Palmyra.txt" 
CRH = "countries/Carrhae.txt" 
APP = "countries/CrusaderAleppo.txt" 
DMC = "countries/CrusaderDamascus.txt" 
IBL = "countries/Ibelin.txt" 
SDN = "countries/Sidon.txt" 
JFF = "countries/Jaffa.txt"
OTJ = "countries/Oultrejordain.txt"

#ANATOLIA
AHL = "countries/Ahis.txt" #Ankara
AL1 = "countries/Alevi.txt" #Shia Baylik revolter tag
ESF = "countries/Esref.txt" #Beysehir
ERC = "countries/Erzincan.txt"
AFS = "countries/Afshar.txt"
HAC = "countries/Haciemir.txt" #Bayramli
HMD = "countries/Hamid.txt" #Aksehir, Isparta, Burdur, Denizli
ISD = "countries/Isfendiar.txt" #Zongdulak, Amastris, Cide
KRI = "countries/Karasi.txt"
KSM = "countries/Kastamoni.txt" #Kastamonu, Tosya, Cankiri, Gerede, Karabuk
KBT = "countries/Kubat.txt" #Sinop
KTL = "countries/Kutlusah.txt" #Amasya
LDI = "countries/Ladik.txt" #Denizli
PHL = "countries/Philadelphia.txt" #Greek city state
PVN = "countries/Pervane.txt" #Sinop, Istifan, Inebolu
SHB = "countries/SahibAta.txt" #Afyon, Aksehir, Isparta
TAC = "countries/Tacettin.txt" #Niksar

#MIDDLE EAST
#Levant
DM5 = "countries/Damascus.txt"
PLS = "countries/Palestine.txt"
SFD = "countries/Safed.txt"
HTY = "countries/Hatay.txt"
NBL = "countries/Nablus.txt"
MSF = "countries/Masyaf.txt"
LTP = "countries/LevantineTripoli.txt"
LJN = "countries/Lajjun.txt"
AKR = "countries/Karak.txt"
HMA = "countries/Hama.txt"
GZA = "countries/Gaza.txt"
BQA = "countries/Beqaa.txt"
HLA = "countries/Halab.txt"
AJL = "countries/Ajloun.txt"
CHF = "countries/Chouf.txt"
BIR = "countries/Beirut.txt"
QUD = "countries/alQuds.txt"
NZR = "countries/Nizari.txt"
ALW = "countries/Alawite.txt"
JDZ = "countries/JabalDruze.txt"
CYR = "countries/Cyrenaica.txt"
#CAUCASUS
#Little Tartary
JBY = "countries/Jamboylik.txt"
JDK = "countries/Jedishkul.txt"
BDJ = "countries/Budjak.txt"
KZY = "countries/Kazyev.txt"
RYL = "countries/Rylsk.txt"
JGL = "countries/Jagoldai.txt"
GLN = "countries/Glinski.txt"
KPC = "countries/Kipchak.txt"
BIN = "countries/Barin.txt"
AYN = "countries/Argin.txt"
SRN = "countries/Shirin.txt"
MSR = "countries/Mansur.txt"
KKO = "countries/KirkOr.txt"
#Cossack Hosts
TKH = "countries/Terek.txt"
GBH = "countries/Grebensky.txt"
DNH = "countries/Don.txt"
YKH = "countries/Yaik.txt"
VGH = "countries/Volga.txt"
KBH = "countries/Kuban.txt"
#Circassia
MTG = "countries/Matrega.txt"
ABK = "countries/Abadzekh.txt"
UBY = "countries/Ubykh.txt"
SHP = "countries/Shapsugs.txt"
NUK = "countries/Natukhai.txt"
KBR = "countries/Kabardia.txt"
BZH = "countries/Bzhedug.txt"
BLY = "countries/Besleney.txt"
TMR = "countries/Temirgoy.txt"
ZHN = "countries/Zhaney.txt"
MGH = "countries/Mamkhegh.txt"
#Upper Caucasus
ABZ = "countries/Abazinia.txt"
KCY = "countries/Karachay.txt"
BLK = "countries/Balkaria.txt"
IGS = "countries/Ingushetia.txt"
VNK = "countries/Vainakhia.txt"
TMN = "countries/Tumen.txt"
ADI = "countries/Andiri.txt"
T4R = "countries/Tarki.txt"
DID = "countries/Didoya.txt"
KTG = "countries/Kaitag.txt"
LEK = "countries/Lekia.txt"
RUT = "countries/Rutul.txt"
TBN = "countries/Tabarasan.txt"
AKN = "countries/Akhtyn.txt"
BGY = "countries/Braguny.txt"
CCI = "countries/CaucasianImamate.txt"
OKY = "countries/Orstkhoy.txt"
IHK = "countries/Ichkeria.txt"
KHH = "countries/Khazaria.txt"
#Georgia
ADJ = "countries/Adjara.txt"
AKZ = "countries/Abkhazia.txt"
ARG = "countries/Aragvi.txt"
GUR = "countries/Guria.txt"
KAK = "countries/Kakheti.txt"
KHV = "countries/Khevsureti.txt"
KRT = "countries/Kartli.txt"
KSN = "countries/Ksani.txt"
LAZ = "countries/Lazistan.txt"
MCB = "countries/Machabeli.txt"
MGL = "countries/Mingrelia.txt"
RCH = "countries/Racha.txt"
SVT = "countries/Svaneti.txt"
TBL = "countries/Tbilisi.txt"
JVA = "countries/Javakheti.txt"
#Azerbaijan
AAN = "countries/Arran.txt"
AZR = "countries/Azerbaijan.txt"
BKK = "countries/Baku.txt"
CKL = "countries/Chakerlu.txt"
CRL = "countries/Chartalakh.txt"
DER = "countries/Derbent.txt"
ERV = "countries/Erivan.txt"
GNJ = "countries/Ganja.txt"
JVD = "countries/Javad.txt"
KBK = "countries/Karabakh.txt"
KDG = "countries/Karadagh.txt"
KKL = "countries/Khalkhal.txt"
KOY = "countries/Khoy.txt"
LYZ = "countries/Layzan.txt"
MKK = "countries/Maku.txt"
MRD = "countries/Marand.txt"
NKK = "countries/NakhichevanKhanate.txt"
QBL = "countries/Qabala.txt"
QUB = "countries/Quba.txt"
SKR = "countries/Shamkor.txt"
SLY = "countries/Salyan.txt"
SRA = "countries/Sarab.txt"
SHG = "countries/Shuragel.txt"
TRZ = "countries/Tabriz.txt"
TLY = "countries/Talysh.txt"
TAT = "countries/Tati.txt"
URM = "countries/Urmia.txt"
ZJN = "countries/Zanjan.txt"
SFV = "countries/SafavidOrder.txt"
#Greater Armenia
KRS = "countries/Kars.txt"
AYR = "countries/Ayrarat.txt"
TA0 = "countries/Tao.txt"
TUB = "countries/Turuberan.txt"
ERZ = "countries/Erzurum.txt" #Changed to the Armenian variant
ATZ = "countries/Artaz.txt"
#ATK = "countries/Artsakh.txt"
DZK = "countries/Dizak.txt"
GGK = "countries/Gegharkunik.txt"
GST = "countries/Gulistan.txt"
HMM = "countries/Hamamshen.txt"
HPT = "countries/Harberd.txt"
JBD = "countries/Jraberd.txt"
LRR = "countries/Lori.txt"
NKH = "countries/Nakhichevan.txt"
SVS = "countries/Sivas.txt"
SYK = "countries/Syunik.txt"
VRD = "countries/Varanda.txt"
VDZ = "countries/VayotsDzor.txt"
YVN = "countries/Yerevan.txt"
GDN = "countries/Gardman.txt"
MOX = "countries/Mokk.txt"
SSO = "countries/Sason.txt"
UTK = "countries/Utik.txt"
PYK = "countries/Paytakaran.txt"
NSH = "countries/NorShirakan.txt"
TSH = "countries/Tashir.txt"
#Assyria
NCH = "countries/Nochiya.txt"
TYA = "countries/Tyari.txt"
KSW = "countries/Keserwan.txt"
TAD = "countries/TurAbdin.txt"
MKE = "countries/Melkite.txt"
MDE = "countries/Mandean.txt"
CLD = "countries/Chaldea.txt"
AME = "countries/Aramea.txt"
ASY = "countries/Assyria.txt"
ATN = "countries/Antiochene.txt"
PHO = "countries/Phoenicia.txt"
#Kurdistan
KRD = "countries/Kurdistan.txt"
BAB = "countries/Baban.txt"
SRE = "countries/Soran.txt"
BHD = "countries/Bahdinan.txt"
BDS = "countries/Baradust.txt"
BAY = "countries/Bayazid.txt"
CGZ = "countries/Cemisgezek.txt"
DBL = "countries/Donboli.txt"
HKK = "countries/Hakkari.txt"
SNJ = "countries/Sinjar.txt"
MYN = "countries/Mokryan.txt"
MSH = "countries/Mush.txt"
NSB = "countries/Nisibin.txt"
#SAN = "countries/Soran.txt" #DUPLICATE
MSU = "countries/Mosul.txt"
YAZ = "countries/Yazidi.txt"
MDS = "countries/Mirdasi.txt"
ZRG = "countries/Zirgan.txt"
SRT = "countries/Siirt.txt"
FRQ = "countries/Farqin.txt"
HRP = "countries/Harput.txt"
JZR = "countries/Jazira.txt"
ZKF = "countries/Zarrinkafsh.txt"
ML1 = "countries/Milli.txt"
JBL = "countries/Jumblatt.txt"
#Turcoman
MDN = "countries/Mardin.txt"
DKB = "countries/Diyarkbekir.txt"
BYB = "countries/Bayburt.txt"
ERG = "countries/Ergani.txt"
ISP = "countries/Ispir.txt"
KMA = "countries/Kemah.txt"
URF = "countries/Urfa.txt"
TRC = "countries/Tercan.txt"

#African
RGG = "countries/Regraga.txt"

#From Comoros mod by MilkandLettuce
BBO = "countries/Bambao.txt"
ANJ = "countries/Anjouan.txt"
MWA = "countries/Mwali.txt"
MAO = "countries/Maore.txt"


#From Riches of Africa mod by Hellwyr
AMX = "countries/Aman.txt"
AOX = "countries/Aonin.txt"
AXD = "countries/Madanda.txt"
BXT = "countries/Tembe.txt"
EMX = "countries/Emakhandzambili.txt"
FBX = "countries/Bafukeng.txt"
GAX = "countries/Gaminun.txt"
GNX = "countries/Ngomane.txt"
GOX = "countries/Gomen.txt"
GZI = "countries/Greater Zimbabwe.txt"
KGX = "countries/Bakgalagadi.txt"
KHL = "countries/Khaugoan.txt"
KHX = "countries/Kharakhoen.txt"
KJX = "countries/Khaikhaun.txt"
KXM = "countries/Makololo.txt"
KXZ = "countries/Karanga.txt"
LHX = "countries/Khumalo.txt"
MYI = "countries/Manyika.txt"
OGO = "countries/Ogain.txt"
OVX = "countries/Ovambo.txt"
QWX = "countries/Qwade.txt"
RGX = "countries/Ronga.txt"
VKX = "countries/Kvango.txt"
WOX = "countries/Hawoben.txt"
WZX = "countries/Swazi.txt"
XBS = "countries/Besotho.txt"
XHS = "countries/Xhosa.txt"
XST = "countries/Tsonga.txt"
ZZX = "countries/Zulu.txt"
AKG = "countries/Agikuyu.txt"
BBX = "countries/Bemba.txt"
CAX = "countries/Calabar.txt"
KWX = "countries/Kwarafa.txt"
OXK = "countries/Okloma.txt"
BXD = "countries/Chewa.txt"
DLO = "countries/Dulo.txt"
LWX = "countries/Lomwe.txt"
MSX = "countries/Maasai.txt"
OKX = "countries/Kaonde.txt"
XLU = "countries/Luo.txt"
MTX = "countries/Matamba.txt"
XMK = "countries/Makonde.txt"
LXB = "countries/Lemba.txt"
KWA = "countries/Musukwa.txt"
NGX = "countries/Ngalagansa.txt"
POK = "countries/Pokomo.txt"
RXD = "countries/Rund.txt"
SLX = "countries/Mpasu.txt"
SYX = "countries/Songye.txt"
XTA = "countries/Taita.txt"
VTA = "countries/Tavara.txt"
TSX = "countries/Tsimihety.txt"
UPS = "countries/Upemba.txt"
XYM = "countries/Wayao.txt"
WDX = "countries/Wanda.txt"
FPX = "countries/Fipa.txt"

#China Tusis
CLJ = "countries/Lijiang.txt"
CYO = "countries/Yaoan.txt"
CSI = "countries/Sizhou.txt"
CSX = "countries/Shuixi.txt"
CSD = "countries/Shuidong.txt"
CBZ = "countries/Bozhou.txt"
CLU = "countries/Luodian.txt"
CPI = "countries/Pingyi.txt"
CYN = "countries/Yunnan.txt"


#Japan Daimyos - From BT China by Konstantinos
ARI = "countries/Arima.txt"
ASN = "countries/Ashina.txt"
ASO = "countries/Aso.txt"
TKA = "countries/Aki-Takeda.txt"
KSB = "countries/Kosuiji-Shiba.txt"
KSA = "countries/Kasai.txt"
KTK = "countries/Kimotsukishi.txt"
KYO = "countries/Kyogoku.txt"
MOG = "countries/Mogami.txt"
NHT = "countries/Noto-Hatakeyama.txt"
NSO = "countries/So.txt"
OSK = "countries/Osaki.txt"
OUE = "countries/Ogigayatsu-Uesugi.txt"
ROK = "countries/Rokkaku.txt"
RZJ = "countries/Ryuzoji.txt"
SAG = "countries/Sagara.txt"
S4T = "countries/Satomi.txt"

#Korean Releasables - LeRoi
GOY = "countries/Goryeo.txt"
SLL = "countries/Silla.txt"
JEJ = "countries/Jeju.txt"
GAY = "countries/Gaya.txt"
BLH = "countries/Balhae.txt"
BKJ = "countries/Baekje.txt"

#Okinawa Additions - LeRoi
MYK = "countries/Miyakojima.txt"
YEY = "countries/Yaeyama.txt"
AMM = "countries/Amami.txt"

#Taiwan tags
AMS = "countries/Amis.txt"
ATY = "countries/Atayal.txt"
BCY = "countries/Bacay.txt"
FVL = "countries/Favorlang.txt"
KVN = "countries/Kavalan.txt"
LKJ = "countries/Lonkjouw.txt"
MKT = "countries/Makatao.txt"
MDD = "countries/Middag.txt"
PYY = "countries/Pinuyumayan.txt"
PWN = "countries/Paiwan.txt"
SRY = "countries/Siraya.txt"
TWN = "countries/Taiwan.txt"
GSH = "countries/Gaoshan.txt"

#South East Asia - further organization needed
HLI = "countries/Hlai.txt"

#Java and Lesser Sunda
JAV = "countries/java-sunda.txt"
GLU = "countries/Galuh.txt"
TGL = "countries/Tegal.txt"
PGH = "countries/Priangan.txt"
PEK = "countries/Pekalongan.txt"
JYK = "countries/Jayakarta.txt"
JEP = "countries/Jepara.txt"

#Sumatra
IDG = "countries/Indragiri.txt"
JMB = "countries/Jambi.txt"
SKB = "countries/SkalaBrak.txt"
SNT = "countries/Siantar.txt"
LGE = "countries/Linge.txt"
BGK = "countries/Bengkulu.txt"
LMP = "countries/Lampung.txt"
LGK = "countries/Langkat.txt"
AHN = "countries/Asahan.txt"
DAY = "countries/Daya.txt"
PID = "countries/Pidie.txt"
SLG = "countries/Selangor.txt"
TGG = "countries/Terengganu.txt"

#Borneo
BEU = "countries/Berau.txt"
SWK = "countries/Sarawak.txt"
BOR = "countries/Borneo.txt"
MLN = "countries/Melanau.txt"
KKG = "countries/Kartanegara.txt"
SMP = "countries/Sampit.txt"
KTA = "countries/Kotawaringin.txt"
SAB = "countries/Sabah.txt"
KKA = "countries/Kalaka.txt"
BGN = "countries/Bulungan.txt"
MPW = "countries/Mempawah.txt"
PSE = "countries/Paser.txt"
SGG = "countries/Sanggau.txt"
SEK = "countries/Sekadau.txt"
SEM = "countries/Selimbau.txt"
SIT = "countries/Silat.txt"
SNN = "countries/Sintang.txt"
TDG = "countries/Tidung.txt"
GNT = "countries/GunungTabur.txt"
SUG = "countries/Sambaliung.txt"
TNB = "countries/TanahBumbu.txt"
MTN = "countries/Matan.txt"

#Sulawesi
BGI = "countries/Banggai.txt"
TLO = "countries/Tallo.txt"
GOW = "countries/Gowa.txt"
AJT = "countries/Adjatapparang.txt"
BNW = "countries/Banawa.txt"
BLN = "countries/Mongondow.txt"
BUO = "countries/Buol.txt"
GTL = "countries/Gorontalo.txt"
MDR = "countries/Mandar.txt"
PIG = "countries/Parigi.txt"
SIG = "countries/Sigi.txt"
TPW = "countries/Tampunganlawo.txt"
TRJ = "countries/Toraja.txt"
T0L = "countries/Tolitoli.txt"
KDR = "countries/Kendari.txt"
SWW = "countries/Suwawa.txt"
MNE = "countries/Moronene.txt"
KNW = "countries/Konawe.txt"
MEK = "countries/Mekongga.txt"
MUA = "countries/Muna.txt"
BTG = "countries/Bantaeng.txt"
SNG = "countries/Siang.txt"

#Maluku and Timor
AMN = "countries/Ambon.txt"
BKU = "countries/Bungku.txt"
BRO = "countries/Buru.txt"
DMP = "countries/Dompu.txt"
KAI = "countries/Kai.txt"
BOW = "countries/Minahasan.txt"
LRT = "countries/Larantuka.txt"
NNU = "countries/Nunusaku.txt"
RJA = "countries/Rajaampat.txt"
SAH = "countries/Sahulau.txt"
TPS = "countries/Topasses.txt"
WHL = "countries/Wehali.txt"
WGM = "countries/Waigama.txt"
WGO = "countries/Waigeo.txt"
SWT = "countries/Salawati.txt"
MOO = "countries/Misool.txt"
LIK = "countries/Likusaen.txt"
KUP = "countries/Kupang.txt"
SNB = "countries/Sonbai.txt"
MGG = "countries/Manggarai.txt"
WLM = "countries/WatanLema.txt"
HML = "countries/Huamual.txt"
HTU = "countries/Hitu.txt"
KSR = "countries/Kisar.txt"

#Halmahera
BAC = "countries/Bacan.txt"
JLO = "countries/Jailolo.txt"
M4K = "countries/Makian.txt"
OBI = "countries/Obi.txt"
BNA = "countries/Banda.txt"
MMK = "countries/Maluku.txt"
MTI = "countries/Morotai.txt"

#Philippines
BYN = "countries/Buayan.txt"
BKN = "countries/Bukidnon.txt"
CTO = "countries/Cotabato.txt"
DPT = "countries/Dapitan.txt"
GDD = "countries/Gaddang.txt"
IBG = "countries/Ibalong.txt"
IFG = "countries/Ifugao.txt"
ILG = "countries/Ilongot.txt"
IVT = "countries/Ivatan.txt"
KPG = "countries/Kapampangan.txt"
MDH = "countries/Mai.txt"
NMN = "countries/Namayan.txt"
SML = "countries/Samal.txt"
SBI = "countries/Sambali.txt"
ILO = "countries/Samtoy.txt"
SGN = "countries/Sarangani.txt"
SUB = "countries/Subanon.txt"
TBW = "countries/Tagbanwa.txt"
TAY = "countries/Taytay.txt"
WRY = "countries/Waray.txt"
YBG = "countries/Ybanag.txt"
YKN = "countries/Yakan.txt"
ZBG = "countries/Zamboango.txt"
MNB = "countries/Manobo.txt"
BGB = "countries/Bagobo.txt"
BBN = "countries/Blaan.txt"
MHL = "countries/Maharlika.txt"
PPP = "countries/Philippines.txt"
BGM = "countries/Bangsamoro.txt"
KKB = "countries/Kankabatok.txt"
M6T = "countries/Mactan.txt"
KAG = "countries/Katugasan.txt"

#Spice Isles
#unsorted
ARU = "countries/Aru.txt"
BRS = "countries/Barus.txt"
KET = "countries/Kengtung.txt"
YGW = "countries/Yawnghwe.txt"
PAH = "countries/Pahang.txt"
KEL = "countries/Kelantan.txt"
MMT = "countries/MongMit.txt"
SKD = "countries/Sukadana.txt"
LDA = "countries/Landak.txt"
PNT = "countries/Pontianak.txt"
SMS = "countries/Sambas.txt"
IDP = "countries/Inderapura.txt"
BNE = "countries/Bone.txt"
WJO = "countries/Wajo.txt"
SPP = "countries/Soppeng.txt"
YGK = "countries/Yogyakarta.txt"
MGK = "countries/Mangkunegaran.txt"
SRK = "countries/Surakarta.txt"
SMD = "countries/Sumedang.txt"##
SRB = "countries/Surabaya.txt"
SPR = "countries/Selaparang.txt"
BMA = "countries/Bima.txt"
SIA = "countries/Siam.txt"
BRM = "countries/Burma.txt"
FMA = "countries/Ma-i.txt"
VIN = "countries/Vietnam.txt"
SVJ = "countries/Srivijaya.txt"
PHM = "countries/Phimai.txt"
FNG = "countries/Fang.txt"
SM8 = "countries/Sumbawa.txt"
KME = "countries/KhmerEmpire.txt"
JAR = "countries/Jarai.txt"
RHD = "countries/Rhade.txt"
MNN = "countries/Mnong.txt"
KOH = "countries/Koho.txt"
DMA = "countries/Ma.txt"

SSP = "countries/Sipsongpanna.txt"
SSC = "countries/Sipsongchautai.txt" # BREAKING MAC FOR SOME REASON
KGC = "countries/Kengcheng.txt"
RIA = "countries/Riau.txt"
SGP = "countries/Singapore.txt"

#New Guinea
ATP = "countries/Aitape.txt"
BAK = "countries/Biak.txt"
FKF = "countries/Fakfak.txt"
KKR = "countries/Kikori.txt"
KLV = "countries/Kilivila.txt"
KWI = "countries/Kiwai.txt"
MLU = "countries/Mailu.txt"
MTU = "countries/Motu.txt"
NMB = "countries/Numbay.txt"
SSI = "countries/Siassi.txt"
WHG = "countries/Wahgi.txt"
DNI = "countries/Dani.txt"
AMU = "countries/Amung.txt"
OKM = "countries/Min.txt"
ASM = "countries/Asmat.txt"
MRN = "countries/Marind.txt"
AID = "countries/Aiduma.txt"
RMB = "countries/Rumbati.txt"
AT1 = "countries/Atiati.txt"
GGD = "countries/Gogodala.txt"
NMA = "countries/Namau.txt"
ELM = "countries/Eleman.txt"
AGN = "countries/Angan.txt"
EGN = "countries/Engan.txt"
HUL = "countries/Huli.txt"
NUU = "countries/Ndu.txt"
BNI = "countries/Baining.txt"
GMA = "countries/Gamai.txt"
TLI = "countries/Tolai.txt"
M4A = "countries/Madara.txt"
MUU = "countries/Manus.txt"
KOW = "countries/Kowiai.txt"

###Oceania 

#Micronesia
CM0 = "countries/Chamorro.txt"
CUK = "countries/Chuuk.txt"
IFK = "countries/Ifalik.txt"
KRR = "countries/Koror.txt"
LLU = "countries/Leluh.txt"
LTK = "countries/Lamotrek.txt"
NMD = "countries/NanMadol.txt"
PLA = "countries/Palau.txt"
WLI = "countries/Woleai.txt"
YAP = "countries/Yap.txt"

#Marshall Islands
ALK = "countries/Ailinkanean.txt"
RNO = "countries/Arno.txt"
EMT = "countries/Eoninmeto.txt"
EOT = "countries/Eoonout.txt"
MJR = "countries/Majuro.txt"
MIL = "countries/Mili.txt"
RTK = "countries/Ratakean.txt"
RAT = "countries/Ratak.txt"
RAL = "countries/Ralik.txt"

#Kiribati
ABM = "countries/Abemama.txt"
BTR = "countries/Butaritari.txt"
B3U = "countries/Beru.txt"
TBT = "countries/Tabiteuea.txt"
TGU = "countries/Tungaru.txt" 
TWA = "countries/Tarawa.txt"

#Nauru
NRU = "countries/Nauru.txt"

#Solomon Islands
AWL = "countries/Akwalaafu.txt"
GZO = "countries/Gizo.txt"
RVI = "countries/Roviana.txt"
BKA = "countries/Buka.txt"
ALU = "countries/Alu.txt"
LUG = "countries/Luangiua.txt"
KIA = "countries/Kia.txt"
BGH = "countries/Bughotu.txt"
AEE = "countries/Areare.txt"
AOI = "countries/Arosi.txt"
TMK = "countries/Taumako.txt"
AWO = "countries/Aiwoo.txt"
WIA = "countries/Lau.txt"

#Vanuatu
EFT = "countries/Efate.txt"
NTG = "countries/Natugu.txt"
SUQ = "countries/Suqe.txt"
NMG = "countries/Nimangki.txt"
NPN = "countries/Nelcompne.txt"

#New Caledonia
KNK = "countries/Kanak.txt"
DJB = "countries/Djubea.txt"
XUU = "countries/Xaracuu.txt"
AJI = "countries/Ajie.txt"
PCI = "countries/Paici.txt"
HMW = "countries/Hootmawaap.txt"
DRH = "countries/Drehu.txt"
IAA = "countries/Iaai.txt"
NGN = "countries/Nangone.txt"

#Fiji
BBG = "countries/Burebasaga.txt"
BUA = "countries/Bua.txt"
CKU = "countries/Cakaudrove.txt"
FIJ = "countries/Fiji.txt"
KDV = "countries/Sigatoka.txt" 
KBN = "countries/Kubuna.txt"
LKB = "countries/Lakeba.txt"
MCT = "countries/Macuata.txt"
NDU = "countries/Naduri.txt" 
VNW = "countries/Vuanirewa.txt"
CO0 = "countries/Colo.txt"

#Samoic
FUT = "countries/Alo.txt"
MNU = "countries/Manua.txt"
RTM = "countries/Rotuma.txt"
SMA = "countries/Samoa.txt"
TKL = "countries/Tokelau.txt"
UVE = "countries/Uvea.txt"
FUF = "countries/Funafuti.txt"

#Tonga
NIU = "countries/Niue.txt"
TGA = "countries/Tonga.txt"
HPI = "countries/Haapai.txt"
VAV = "countries/Vavau.txt"

#Cook Islands
MGA = "countries/Mangaia.txt"
RRT = "countries/Rarotonga.txt"

#Society Islands
BBR = "countries/BoraBora.txt"
HUH = "countries/Huahine.txt"
RAI = "countries/Raiatea.txt"
THT = "countries/Tahiti.txt"

#Tuamotu
MGV = "countries/Mangareva.txt"
PRT = "countries/Parata.txt"
R47 = "countries/Rangiroa.txt"
PTC = "countries/Pitcairn.txt"
VHT = "countries/Vahitu.txt"
MRG = "countries/Maraga.txt"
FGT = "countries/Fangatau.txt"
HAO = "countries/Hao.txt"
TPH = "countries/Tapuhoe.txt"
TRO = "countries/Tauaro.txt"

#New Zealand
AOT = "countries/Aotearoa.txt"
AO7 = "countries/Aotea.txt"
AWA = "countries/TeArawa.txt"
KTM = "countries/KatiMamoe.txt"
MHA = "countries/Marutuaha.txt"
MRO = "countries/Moriori.txt"
MRW = "countries/Muriwhenua.txt"
NKG = "countries/NgatiKahungunu.txt"
NPH = "countries/Ngapuhi.txt"
NPO = "countries/NgatiPorou.txt"
NTO = "countries/NgaiTuhoe.txt"
NTU = "countries/NgaiTahu.txt"
NTW = "countries/NgatiTuwharetoa.txt"
NWT = "countries/NgatiWhatua.txt"
RNG = "countries/Rangitane.txt"
TGM = "countries/TaurangaMoana.txt"
TRW = "countries/TeRapuwei.txt"
WAI = "countries/Waitaha.txt"
WHN = "countries/Whanganui.txt"
WKT = "countries/Waikato.txt"
TTW = "countries/TeAtiawa.txt"
HWE = "countries/Hawea.txt"
KHT = "countries/KahuiTipua.txt"
MNP = "countries/NgatiManiapoto.txt"
NAW = "countries/NgatiAwa.txt"
NPA = "countries/NgatiApa.txt"
RGW = "countries/NgatiRongomaiwahine.txt"
RKW = "countries/NgatiRaukawa.txt"
TOA = "countries/NgatiToa.txt"
TTU = "countries/TeTauIhu.txt"
TWK = "countries/TeWhakatohea.txt"
WGI = "countries/NgatiWairangi.txt"

#Hawaii
HNA = "countries/Hana.txt"
HWI = "countries/Hawaii.txt"
KAU = "countries/Kauai.txt"
MAU = "countries/Maui.txt"
MOK = "countries/Molokai.txt"
OAH = "countries/Oahu.txt" 
HLO = "countries/Hilo.txt"
KOA = "countries/Kohala.txt"
KNA = "countries/Kona.txt"
HKA = "countries/Kau.txt"

#Marquesas
NKU = "countries/Nuku.txt"
PEP = "countries/Pepane.txt"
TEL = "countries/TeLi.txt"
TFE = "countries/TeFenuaEnata.txt"
TPI = "countries/TaiPi.txt"
UPO = "countries/UaPou.txt"

#Austral
RMT = "countries/Rimatara.txt"
RUR = "countries/Rurutu.txt"

#Rapan
RNU = "countries/RapaNui.txt"
RPA = "countries/RapaIti.txt"

#Carpathia
BAA = "countries/Banat.txt"
BGD = "countries/Belgrade.txt"
FGR = "countries/Fagaras.txt"
JZY = "countries/Jazygia.txt"
KUN = "countries/Kunsag.txt"
KYL = "countries/Kiralyfold.txt"
MCS = "countries/Macso.txt"
MRM = "countries/Maramures.txt"
PTP = "countries/Pentapolitana.txt"
SYM = "countries/Syrmia.txt"
SVR = "countries/Severin.txt"
SZK = "countries/Szekelyfold.txt"
TGH = "countries/Tigheci.txt"
TIT = "countries/Taborites.txt"
UHN = "countries/UpperHungary.txt"
USR = "countries/Usora.txt"
ZKR = "countries/Zakarpattia.txt"

#Balkans and Dalmatia
AR1 = "countries/Arianiti.txt"
BAT = "countries/Berat.txt"
BOD = "countries/Bodonitsa.txt"
CIO = "countries/Chios.txt"
CPH = "countries/Cephalonia.txt"
PUL = "countries/Pult.txt"
DJK = "countries/DonjiKraji.txt"
DKG = "countries/Dukagjina.txt"
DZO = "countries/Durazzo.txt"
FRK = "countries/Krk.txt"
GJR = "countries/Gjirokaster.txt"
HMR = "countries/Himara.txt"
IST = "countries/Istria.txt"
KST = "countries/Kastrioti.txt"
KAY = "countries/Kaykavus.txt"
MOT = "countries/Mani.txt"
MII = "countries/Misia.txt"
OHD = "countries/Ohrid.txt"
PLJ = "countries/Poljica.txt"
SBN = "countries/Sibenick.txt"
SCR = "countries/Scuria.txt"
S4L = "countries/Salona.txt"
S1T = "countries/Split.txt"
TSK = "countries/Thessaloniki.txt"
VLO = "countries/Vlore.txt"
ZDA = "countries/Zadar.txt"
ZDR = "countries/Zadrima.txt"
ZET = "countries/Zeta.txt"
ZRI = "countries/Zrin.txt"
ABA = "countries/VenetianAlbania.txt"
AGK = "countries/Angelokastron.txt"
AIN = "countries/Ainos.txt"
ART = "countries/Arta.txt"
ARV = "countries/Arvanites.txt"
BCV = "countries/Branicevo.txt"
DLM = "countries/Dalmatia.txt"
IOA = "countries/Ioannina.txt"
KSV = "countries/Kosovo.txt"
KTR = "countries/Kotor.txt"
NAU = "countries/Nauplia.txt"
ORS = "countries/Orestis.txt"
PLP = "countries/Prilep.txt"
RCA = "countries/Rascia.txt"
SRR = "countries/Serres.txt"
THR = "countries/Thrace.txt"
THS = "countries/Thessaly.txt"
ZGR = "countries/Zagorisians.txt"
OLT = "countries/Oltenia.txt"
FAM = "countries/FeudumAconganorum.txt"
ADS = "countries/Andros.txt"
SM5 = "countries/Samos.txt"
ICR = "countries/Icaria.txt"
SPT = "countries/SeptinsularRepublic.txt"
VCH = "countries/Vlachia.txt"
RMI = "countries/Romani.txt"
ORT = "countries/Ortenburg.txt"
ZGJ = "countries/Zagorje.txt"

#Central Asia
QGT = "countries/Qongrat.txt"
ESE = "countries/Esen-Eli.txt"
ERS = "countries/Ersari.txt"
YQA = "countries/Yaqa.txt"
SL0 = "countries/Salor.txt"
ADQ = "countries/Adaqli.txt"
4LE = "countries/Ali-Eli.txt"
KZE = "countries/Khizir-Eli.txt"
HSR = "countries/Hisor.txt"
BDK = "countries/Badakhshan.txt"
FEG = "countries/Ferghana.txt"
DVZ = "countries/Darvaz.txt"
RSH = "countries/Rushan.txt"
SGH = "countries/Shighnan.txt"
WAK = "countries/Wakhan.txt"
YGN = "countries/Yaghnob.txt"

#New Tribes S-America
AHK = "countries/Ashaninka.txt"
CAR = "countries/Cariri.txt"
CCH = "countries/Chincha.txt"
CHN = "countries/Chane.txt"
CMA = "countries/Camanchaco.txt"
CNI = "countries/Canar.txt"
CRG = "countries/Chiriguano.txt"
GCV = "countries/Guancavalica.txt"
GUC = "countries/Guaycuru.txt"
JIV = "countries/Jivaro.txt"
KUZ = "countries/Kunza.txt"
M4N = "countries/Manao.txt"
OMC = "countries/Omaguacua.txt"
OMG = "countries/Omagua.txt"
TMI = "countries/Temimino.txt"

###Special Domain Tags
#Ottomans
ISR = "countries/OttomanEgypt.txt"
#Portugal
MR1 = "countries/Marrocos.txt" #Portuguese puppet Morocco
RJ1 = "countries/Hindustao.txt" #Portuguese puppet India
#planned
#Castile
#MR2 = "countries/Marruecos.txt" #Spanish puppet Morocco
#AL2 = "countries/Argelia.txt" #Spanish puppet Algeria
#TN2 = "countries/Tunez.txt" #Spanish puppet Tunisia
#France
#MR3 = "countries/Maroc.txt" #French puppet Morocco
#AL1 = "countries/Algerie.txt" #French puppet Algeria
#TN1 = "countries/Tunisie.txt" #French puppet Tunisia
#RJ2 = "countries/FrenchRaj.txt" #French puppet India
#England
#AQ1 = "countries/Aquitania.txt" #English puppet Gascony
#RJ3 = "countries/EnglishRaj.txt" #English puppet India

#Poland
RSJ = "countries/Rosja.txt" #Polish puppet Russia